CREATE (Myriel: Person {name: 'Myriel'})
CREATE (Napoleon: Person {name: 'Napoleon'})
CREATE (Mlle_Baptistine: Person {name: 'Mlle_Baptistine'})
CREATE (Mme_Magloire: Person {name: 'Mme_Magloire'})
CREATE (CountessdeLo: Person {name: 'CountessdeLo'})
CREATE (Geborand: Person {name: 'Geborand'})
CREATE (Champtercier: Person {name: 'Champtercier'})
CREATE (Cravatte: Person {name: 'Cravatte'})
CREATE (Count: Person {name: 'Count'})
CREATE (OldMan: Person {name: 'OldMan'})
CREATE (Labarre: Person {name: 'Labarre'})
CREATE (Valjean: Person {name: 'Valjean'})
CREATE (Marguerite: Person {name: 'Marguerite'})
CREATE (Mme_deR: Person {name: 'Mme_deR'})
CREATE (Isabeau: Person {name: 'Isabeau'})
CREATE (Gervais: Person {name: 'Gervais'})
CREATE (Tholomyes: Person {name: 'Tholomyes'})
CREATE (Listolier: Person {name: 'Listolier'})
CREATE (Fameuil: Person {name: 'Fameuil'})
CREATE (Blacheville: Person {name: 'Blacheville'})
CREATE (Favourite: Person {name: 'Favourite'})
CREATE (Dahlia: Person {name: 'Dahlia'})
CREATE (Zephine: Person {name: 'Zephine'})
CREATE (Fantine: Person {name: 'Fantine'})
CREATE (Mme_Thenardier: Person {name: 'Mme_Thenardier'})
CREATE (Thenardier: Person {name: 'Thenardier'})
CREATE (Cosette: Person {name: 'Cosette'})
CREATE (Javert: Person {name: 'Javert'})
CREATE (Fauchelevent: Person {name: 'Fauchelevent'})
CREATE (Bamatabois: Person {name: 'Bamatabois'})
CREATE (Perpetue: Person {name: 'Perpetue'})
CREATE (Simplice: Person {name: 'Simplice'})
CREATE (Scaufflaire: Person {name: 'Scaufflaire'})
CREATE (Woman1: Person {name: 'Woman1'})
CREATE (Judge: Person {name: 'Judge'})
CREATE (Champmathieu: Person {name: 'Champmathieu'})
CREATE (Brevet: Person {name: 'Brevet'})
CREATE (Chenildieu: Person {name: 'Chenildieu'})
CREATE (Cochepaille: Person {name: 'Cochepaille'})
CREATE (Pontmercy: Person {name: 'Pontmercy'})
CREATE (Boulatruelle: Person {name: 'Boulatruelle'})
CREATE (Eponine: Person {name: 'Eponine'})
CREATE (Anzelma: Person {name: 'Anzelma'})
CREATE (Woman2: Person {name: 'Woman2'})
CREATE (MotherInnocent: Person {name: 'MotherInnocent'})
CREATE (Gribier: Person {name: 'Gribier'})
CREATE (Jondrette: Person {name: 'Jondrette'})
CREATE (Mme_Burgon: Person {name: 'Mme_Burgon'})
CREATE (Gavroche: Person {name: 'Gavroche'})
CREATE (Gillenormand: Person {name: 'Gillenormand'})
CREATE (Magnon: Person {name: 'Magnon'})
CREATE (Mlle_Gillenormand: Person {name: 'Mlle_Gillenormand'})
CREATE (Mme_Pontmercy: Person {name: 'Mme_Pontmercy'})
CREATE (Mlle_Vaubois: Person {name: 'Mlle_Vaubois'})
CREATE (Lt_Gillenormand: Person {name: 'Lt_Gillenormand'})
CREATE (Marius: Person {name: 'Marius'})
CREATE (BaronessT: Person {name: 'BaronessT'})
CREATE (Mabeuf: Person {name: 'Mabeuf'})
CREATE (Enjolras: Person {name: 'Enjolras'})
CREATE (Combeferre: Person {name: 'Combeferre'})
CREATE (Prouvaire: Person {name: 'Prouvaire'})
CREATE (Feuilly: Person {name: 'Feuilly'})
CREATE (Courfeyrac: Person {name: 'Courfeyrac'})
CREATE (Bahorel: Person {name: 'Bahorel'})
CREATE (Bossuet: Person {name: 'Bossuet'})
CREATE (Joly: Person {name: 'Joly'})
CREATE (Grantaire: Person {name: 'Grantaire'})
CREATE (MotherPlutarch: Person {name: 'MotherPlutarch'})
CREATE (Gueulemer: Person {name: 'Gueulemer'})
CREATE (Babet: Person {name: 'Babet'})
CREATE (Claquesous: Person {name: 'Claquesous'})
CREATE (Montparnasse: Person {name: 'Montparnasse'})
CREATE (Toussaint: Person {name: 'Toussaint'})
CREATE (Child1: Person {name: 'Child1'})
CREATE (Child2: Person {name: 'Child2'})
CREATE (Brujon: Person {name: 'Brujon'})
CREATE (Mme_Hucheloup: Person {name: 'Mme_Hucheloup'})
